WWWWWWWWWWWWWWWWWWWWWWWWWWWWWWWWWWWWWWWW
W                                      W
WX                                     W
WW                                     W
W                                     WW
W                                  W   W
W                    H                 W
W                                      W
W                               W      W
W                                      W
W                                      W
W          W                           W
W                            W         W
W                                      W
W                                      W
W                                      W
W                                      W
W                         W            W
W                         W     S      W
W                         WWWWWWWWWWWWWW
W                                      W
W                                      W
W          w                           W
W                                      W
W                                      W
W                                      W
W                          F           W
W                          WWWW        W
W                                      W
W                         S            W
WPPPPPPPPPP                            W
WWWWWWWWWWWWWWWWWWWWWWWWWWWWWWWWWWWWWWWW